1111111111
1        1
1  11    1
1  1     1111111111111111111111111
1                                6
1111                             6
1        1111111111111111111111111
1 1      1
1 1      1
1511111111