1111111111111111111111111111111111111
1    11111111111111111111111111111111
111   1111111111111111111111111111111
1111   111111111111111111111111111111
11111   11111111111111111111111111111
1111166666666666666666666666666666666 