11111111111111
1    111111111
1      1111111
1    1111
1  1111
2   222222222
2   222222222
2666222222222